EA inc/east.xpm

NO inc/north.xpm

SO inc/south.xpm

WE inc/west.xpm

C 55,182,193
F 0,0,0


111111111111111111111111111111111
11E000000000000000000000000001
100100000000111111111111111111
11111111110000000000111111
1000000000000000000000001
111111111111111111110111
111111111111111111111
1