EA inc/east.xpm

NO inc/north.xpm

SO inc/south.xpm

WE inc/west.xpm

C 0,255,0
F 0,0,0

111111111111
100100000001
101000000001
1100N0010001
1010000D0001
101000010001
101000000001
111111111111