EA inc/east.xpm

NO inc/north.xpm

SO inc/south.xpm

WE inc/west.xpm

C 255,182,193
F 0,0,0

        1111111111111111111111
        1000000000000000000001
        10000000000000000000011111111
        10000000000000000000000000001
1111111110000000000000000000000000001
1000000010000000000000000000000000001
1000000010000000000000000000000000001
100000001000011111111111110011111111
111111011000010000000000000001
100000001000010000000000000001
100000001000011111100111111111
100000000000010000000000000001
1000000000W0010000000000000001
100000000000010000000000000001
111111111111111111111111111111