F 0,0,                0
EA 					        inc/east.xpm			

                    										NO inc/north.xpm   



C 255    ,255	,	193

SO inc/south.xpm


WE inc/west.xpm



111111111   111111111111
1001         1
100011111   101
101000001    1
1100N0001
111111111
   101  1  11
1111111111
1
        11