F 0,0,                0
EA 					        inc/east.xpm			

                    										NO inc/north.xpm   



C 255    ,255	,	193

SO inc/south.xpm


WE inc/west.xpm



111111111111111111111
1001
1001
10101111111
1100N0001
111111111
101111
1111111111
11
11