EA inc/east.xpm

NO inc/north.xpm

SO inc/south.xpm

WE inc/west.xpm

C 55,182,193
F 0,0,0


1111
11N1
1001
1111