EA inc/east.xpm			

NO inc/north.xpm   

SO inc/south.xpm

WE inc/west.xpm

C 255    ,255	,	193
F 0,0,0

111111111
1001
100011111	1
101000001
1100N0001
111111111




111111111