EA inc/east.xpm

NO inc/north.xpm

SO inc/south.xpm

WE inc/west.xpm

C 255,182,193
F 0,0,0

111111
100101
101001
1100N1
111111