EA inc/east.xpm

NO inc/north.xpm

SO inc/south.xpm

WE inc/west.xpm

C 255,182,193
F 0,0,0

1111111111111
1001000000001
1010000000001
1100N00000001
1000001010001
1000001111D11
1111111111 11